XXXXXXXXXXXXXXXXXXX
X.................X
X.XXXXXXXXXXXXX.X.X
X.XXCX.........CX.X
X.X..X.XXXXXXXXXXXX
X.X.XX.X..........X
X.X...XXSXXX.XXX.XX
X...X....X.X.CX...X
X..XXX.XXX.XXXX.X.X
X......X........X.X
XXXX.XXX.X.XXX.XX.X
X........X..CX..XCX
XXXXXXXXXXXXXXXXXXX